||||||||||||||||||||||||||||||||||||||||
||||,,|||||||,,,,|,,,,,,||,,,,,,,,,|||||
|||,,,,||||||,,,,|,,,,,,|,,,,,,,,,,,||||
|||,,,,,||||||,,||,,,,,,,,,,,,,,,,,,,|||
|,,|,,,,,||,,,,,,,,,,,,,|,,,,,,,,,,,,,||
|,,,|,,,,,,,,|,,|,,,,,,,|,,,,,,,,,,,,,,|
|,,,,|,,,,,,|,,,,|,,,|||||||||||||||||||
|,,,,,|,,,,|,,,,,,|,,,,,||||||||||||||||
|,,,,,,|,,|,,,,,,,,|,,,,||||||||||||||||
|,,,,,,,,,|,,,,,,,,,,,,,||||||||||||||||
|,,,,,,,,,|,,,,,,,,,,,,,,,,,,,,,,,,,,,,|
|,,,,,,|,,|,,,,,,,,|,,,|,,,,,,,,,,,,,,||
|,,,,,|,,,,|,,,,,,|,,,,|,,,,,,,,,,,,,|||
|,,,,|,,,,,,|,,,,|,,,,,,|,,,,,,,,,,|||||
|,,,|,,,,,,,,||||,,,|,,,,|,,,,,,,,||||||
|,,|,,,,,||,,,,,,,,|||,,,,||||||||||||||
|||,,,,,||||||,,|||||||,,,,,,,|,,,,,||||
|||,,,,||||||,,,,|||||||,,,,,,,,,,,,,|||
||||,,|||||||,,,,||||||||,,,,,|,,,,,||||
||||||||||||||||||||||||||||||||||||||||
